0000000000000000000
0000011112111100000
0000010001000100000
0111111111111111110
0100101000001010010
0100101000001010010
0100101000001010010
0100101000001010010
0100101000001010010
010010a00000d010010
0100101000001010010
0100b010000010e0010
0100101000001010010
0c001010000010100f0
0100101000001010010
0100101000001010010
0100101000001010010
0100101000001010010
0100101000001010010
0100101110111010010
0100101010101010010
0101111110111111010
0101000100010001010
0101111113111111010
0100000001000000010
0111111111111111110
0000000000000000000
