0000000000
0011111110
00a0001020
0010001000
001000b000
0010001000
0010001000
0010001000
0010001000
0010001000
0010001000
0010111000
0010101000
0010101000
0011105110
0010001010
0111111510
0100000100
0111111300
0000000000
