000000000000000000
001111111a11111110
001010000000001010
021110000000001310
001010000000001010
001111111A11111110
000000000000000000
