0000000000000000000000000
0000000000000000000111110
0011111111111111111100010
0010000000000000000100010
0010000000111110000100010
00b0000000100010000100010
0010000000111110000113110
0210000000001000000100000
001111a111111111111100000
0000000000000000000000000
