0000000000000000000000000
0000000000000000000111110
0011111111111110111100010
00b0000000000011100100010
0010000001110000000113110
0210000001010000000100000
0011a11011010111111100000
0000001110011100000000000
0000000000000000000000000
