0000000000000000000000000000
0000000000000000000001111110
0000111111111111111111000010
0000b00000000000000001000010
0000100000000000000001000010
0000100000000000000001000010
0000100000000000000001000010
0011100000000000000001111110
00101111a1111111111111000010
0211100000000000000001113110
00101111A1111111111111000010
0011100000000000000001111110
0000100000000000000001000010
0000100000000000000001000010
0000100000000000000001000010
0000B00000000000000001000010
0000111111111111111111000010
0000000000000000000001111110
0000000000000000000000000000
