000000000000000000000000000
001111000000000000000111110
0010011111111a1111111100010
021111000000000000000131110
0010011111111A1111111100010
001111000000000000000111110
000000000000000000000000000
