0000000000000000000000000
0000000000000000000111110
0011111111111111111100010
0010000000000000000100010
0010111111111111110100010
00b0100000000000010100010
0010111111111111110113110
0210000000001000000100000
001111a111111111111100000
0000000000000000000000000
