0000000000000000
01a1111111111110
0100000000001010
011b111111111010
0100000010001010
0200000010003110
0000000010000000
0000001110000000
0000000000000000