0000000000000000
01a1111111111110
0100000000001010
011b111111111010
0100010001001010
0200010001003110
0000010001000000
0000011111000000
0000000000000000