0000000000000000
0151111111111110
0100000000001010
0116111111111010
0100000010101010
0200011110103110
0100010000100000
0100011110100000
0100000010100000
0111111111100000
0000000000000000