0000000000000000
0151111111111110
0100000000001010
0116111111111010
0100000010001010
0200000010003110
0000000010001010
0000001110001010
0000000000001110
0000000000000000