00000000000000000000
00001111111a11111000
00111000000000001110
00101111111c11111010
00100000000000000010
02101111111b11111030
00111000000000001110
00001111111d11111000
00000000000000000000
