000000000000000000
0111a1111111111110
010000000000000010
01000000001b100010
010000000010100010
010001111110101110
010001000000101010
010001000000111010
010001000000000010
010001000111001110
010001000101001010
01000100010c111010
010001000100000010
010001011100000010
010001010100000010
010001111100000010
010001000111110010
010001000100011320
010001000111110000
010001111100000000
011111000000000000
000000000000000000
