00000000
00a11110
00101020
00101000
00101000
00101000
00101000
0010b000
00101000
00101000
00101000
00101000
00101000
00101110
00101010
01111110
01000100
01111300
00000000
