0000000000
00a1111000
0010102000
0010100000
0010101110
0010101010
0010b11010
0010000010
0010000010
0010000010
0010000010
0010000010
0010111110
0010100000
0010111000
0010101000
0111111000
0100010000
0111130000
0000000000
