00000000
00111110
00a01020
00101000
00101000
00101000
00101000
0010b000
00101000
00101000
00101000
00101000
00101000
00101000
00101000
00101000
00101000
00101000
01101100
01000100
01111300
00000000
