000000000
011111110
010101020
010101000
010101000
010101000
010101000
010a0b000
010101000
010101000
010101000
010101000
010101000
010101000
010101000
010101000
010101000
010101000
010101100
010100100
011111300
000000000
