0000000000000000000
0000000112110000000
0000000101010000000
0111111111111111110
0100101000001010010
0100101000001010010
0100101000001010010
0100101000001010010
0100101000001010010
010010a000001010010
0100101000001010010
0100b01000001010010
0100101000001010010
0c00101000001010010
0100101000001010010
0100101000001010010
0100101000001010010
0100101000001010010
0100101000001010010
0100101110111010010
0100101010101010010
0101111110111111010
0101000100010001010
0101111113111111010
0100000001000000010
0111111111111111110
0000000000000000000
