0000000000000000000
0000000002000000000
0000011111111100000
0000010010100100000
0111111111111111110
0100101000001010010
0100101000001010010
0100101000001010010
0100101000001010010
0100101000001010010
010010a00000A010010
0100101000001010010
0100b010000010B0010
0100101000001010010
0c001010000010100C0
0100101000001010010
0100101000001010010
0100101000001010010
0100101000001010010
0100101000001010010
0100101110111010010
0100101010101010010
0101111110111111010
0101000100010001010
0101111111111111010
0100000003000000010
0100000001000000010
0111111111111111110
0000000000000000000
